Alanine	Ala	A	"GCU,GCC,GCA,GCG"
Arginine	Arg	R	"CGU,CGC,CGA,CGG,AGA,AGG"
Asparagine	Asn	N	"AAU,AAC"
Asparticacid	Asp	D	"GAU,GAC"
Cystine	Cys	C	"UGU,UGC"
Glutamicacid	Glu	E	"GAA,GAG"
Glutarnine	Gln	Q	"CAA,CAG"
Glycine	Gly	G	"GGU,GGC,GGA,GGG"
Histidine	His	H	"CAU,CAC"
Isoleucine	Ile	I	"AUU,AUC,AUA"
Leucine	Leu	L	"UUA,UUG,CUU,CUC,CUA,CUG"
Lysine	Lys	K	"AAA,AAG"
Methionine	Met	M	AUG
Phenylalanine	Phe	F	"UUU,UUC"
Proline	Pro	P	"CCU,CCC,CCA,CCG"
Serine	Ser	S	"UCU,UCC,UCA,UCG,AGU,AGC"
Threonine	Thr	T	"ACU,ACC,ACA,ACG"
Tryptophan	Trp	W	UGG
Tyrosine	Tyr	Y	"UAU,UAC"
Valine	Val	V	"GUU,GUC,GUA,GUG"
Start	Start	Start	AUG
Stop	Stop	Stop	"UAG,UGA,UAA"
